┏┳━━━━━━┳━━━┳━━━┓
┃┃╺━━━┳┓┗╸╻╻┃╻╻╻┃
┃┣┓╻╻╻┃┃╺╸┃┃┗┛┃┃┃
┃┃┃┃┃┃┃┃╺━┻┛╺━┻┫┃
┃┃╹┃┃┃┃┃╺━━╸╺━╸┃┃
┃┃╻┃╹╹╹┃╺━━╸╺━╸┃┃
┃┃┃┃╻╻╻┃╺━━╸╺━╸┃┃
┃┗┛╹┃┃┃┣━━━━━━━┫┃
┃┏┓╻┃┃┃┃ ┏━━━━╸╹┃
┃┃┃┃┃┃┃┣━┻━━━━━┓┃
┃┃┃┃╹╹╹┃╺━━╸╺━╸┃┃
┃┃╹┃╻╻╻┃╺━━╸╺━╸┃┃
┃┃╻┃┃┃┃┃╺━━╸╺━╸┃┃
┃┃┃┃┃┃┃┃╺━┳┓╺━┳┫┃
┃┣┛╹╹╹┃┃╺╸┃┃┏┓┃┃┃
┃┃╺━━━┻┛┏╸╹╹┃╹╹╹┃
┗┻━━━━━━┻━━━┻━━━┛
