┏┳┳┳┳┳┳┳┳┳┳┳┳┳┳┳┓
┃┃┃┃┃┃┃┃┃┃┃┃┃┃┃┃┃
┃┃┃┃┃┃┃┃┃┃┃┃┃┃┃┃┃
┃┃┃┃┃┃┃┃┃┃┃┃┃┃┃┃┃
┃┃┃┃┃┃┃┃┃┃┃┃┃┃┃┃┃
┃┃┃┃┃┃┃┃┃┃┃┃┃┃┃┃┃
┃┃┃┃┃┃┃┃┃┃┃┃┃┃┃┃┃
┃┃┃┃┃┃┃┃┃┃┃┃┃┃┃┃┃
┃┃┃┃┃┃┃┃┃┃┃┃┃┃┃┃┃
┃┃┃┃┃┃┃┃┃┃┃┃┃┃┃┃┃
┃┃┃┃┃┃┃┃┃┃┃┃┃┃┃┃┃
┃┃┃┃┃┃┃┃┃┃┃┃┃┃┃┃┃
┃┃┃┃┃┃┃┃┃┃┃┃┃┃┃┃┃
┃┃┃┃┃┃┃┃┃┃┃┃┃┃┃┃┃
┃┃┃┃┃┃┃┃┃┃┃┃┃┃┃┃┃
┃┃┃┃┃┃┃┃┃┃┃┃┃┃┃┃┃
┗┻┻┻┻┻┻┻┻┻┻┻┻┻┻┻┛
