┏┳━━━━━━━━━━━━━━┓
┃┃┏━━━━━━╸╺━╸╺━┓┃
┃╹┣━━━━╸╺━━┓╺━┓┃┃
┃╺┫┏━━━━━━╸┗━┓┃┃┃
┃╻┃┃┏━━━┳━━━┳┫┃┃┃
┃┃┃┃┃┏━━╋━━┓┃┃┃┃┃
┃┃┃┃┃┃┏━┻━┓┃╹┃┃┃┃
┃┃┃┃┃┃┃┏━┓┃┃╻┃┃┃┃
┃┃┃╹╹╹╹╹ ┃┃╹┃┃┃┃┃
┃┃┃╻╻╻╻╺━┛┃╻┃┃╹┃┃
┃┃┃┃┃┃┣━╸╺┛┃┃┃╻┃┃
┃┃┃┃┣┻┻━━━━┛┃┃┃╹┃
┃╹┃┃┗━━━╸╺━━┛┃┃╻┃
┃╺┫┗━━━━━━━━━┫┃┃┃
┃╻┣━━━━━┓╺━━━┻┻┛┃
┃┃┗━╸╺━━┻━━━━━━╸┃
┗┻━━━━━━━━━━━━━━┛
