┏┳━━━━━━━━━━━━━━┓
┃┃┏━━━━━━╸╺━╸╺━┓┃
┃╹┣━━━━╸╺━━┓╺━┓┃┃
┃╺┫┏━━┳━━━╸┗━┓┃┃┃
┃╻┃┃┏━┻━┳━━━┳┫┃┃┃
┃┃┃┃┃┏━━╋━━┓┃┃┃╹┃
┃┃┃┃┃┃┏━┻━┓┃╹┃┃╻┃
┃┃┃┃┃┃┃┏━┓┃┃╻┃┃┃┃
┃┃┃╹╹╹┃╹ ┃┃╹┃┃┃┃┃
┃┃┃╻╻╻┣━━┛┃╻┃┃╹┃┃
┃┃┃┃┃┃┣━╸╺┛┃┃┃╻┃┃
┃┃┃┃┣┻┻━━━━┛┃┃┃╹┃
┃╹┃┃┗━━━╸╺━━┛┃┃╻┃
┃╺┫┗━━━━━━━━━┫┃┃┃
┃╻┣━━━━━┓╺━━━┻┻┛┃
┃┃┗━╸╺━━┻━━━━━━╸┃
┗┻━━━━━━━━━━━━━━┛
